NO textures/simonkraft/wet_sponge.xpm
SO textures/simonkraft/wet_sponge.xpm
WE textures/simonkraft/wet_sponge.xpm
EA textures/simonkraft/wet_sponge.xpm

F 164,169,20
C 153,204,255

11111111111111111111
10100000100000000001
10101010101111110001
10001010001000001001
11111010111110101111
10000010100010100001
10111110101110111111
101000001010000W0111
10101111101001111011
10101000101000001011
10111010101000101011
10000010101000101001
11111110101011101111111111
10111010111010111011
10111010111010111011
10111010111010111011
10111010111010111011
10111010111010111011
10111010111010111011
10111010111010111011
10111010111010111011
10111010111010111011
10111010111010111011
10111010111010111011
10111010111010111011
10111010111010111011
10111010111010111011
10111010111010111011
10111010111010111011
11111111111111111111
