NO textures/simonkraft/talai.xpm               
SO textures/simonkraft/talai.xpm
EA textures/simonkraft/talai.xpm
WE textures/simonkraft/talai.xpm
DO textures/simonkraft/bab.xpm

C 0,0,0
F 45,33,37
111111111111111
100000000010001
100N000000D0001
100000000010001
1111111D1111111
110000000010011
100001111100001
1100001110001D1
111000010000111
111100000001111
111110000011111
111111111111111